NO ./textures/simple.xpm
SO ./textures/simple.xpm
WE ./textures/simple.xpm
EA ./textures/simple.xpm

F 220,100,0
C 225,30,0

 1111111
10000000
100000001
1000N0001
100000001
100000001
 1111111